[
    [2, 9, 3, 4, 5, 7, 6, 8, 1],
    [4, 7, 5, 1, 8, 6, 3, 9, 2],
    [1, 6, 8, 3, 9, 2, 7, 4, 5],
    [9, 4, 2, 5, 7, 1, 8, 6, 3],
    [3, 8, 1, 6, 2, 9, 5, 7, 4],
    [6, 5, 7, 8, 3, 4, 1, 2, 9],
    [7, 2, 6, 9, 1, 3, 4, 5, 8],
    [5, 1, 4, 2, 6, 8, 9, 3, 7],
    [8, 3, 9, 7, 4, 5, 2, 1, 6]
]
