[
    [6, 5, 7, 9, 4, 1, 2, 3, 8],
    [1, 2, 3, 6, 5, 8, 9, 4, 7],
    [8, 9, 4, 2, 3, 7, 6, 5, 1],
    [7, 6, 5, 1, 2, 3, 4, 8, 9],
    [2, 3, 1, 8, 9, 4, 5, 7, 6],
    [9, 4, 8, 7, 6, 5, 1, 2, 3],
    [5, 1, 2, 3, 7, 6, 8, 9, 4],
    [3, 8, 9, 4, 1, 2, 7, 6, 5],
    [4, 7, 6, 5, 8, 9, 3, 1, 2]
]
